(family) doctor, general practitioner	de huisarts
(news)paper, magazine	het blad
(pair of) knickers, underpants	de slip
(pair of) trousers	de broek
(political) party	de partij
(traffic) lane	de rijstrook
1. nephew 2. cousin	de neef
1. niece 2. cousin	de nicht
a beer	het pintje
a bit	wat
a pity, too bad	jammer
about, approximately	ongeveer
above	boven
absolutely	absoluut
academic	academisch(e)
accent	het accent
accident	het ongeluk
accident	het ongeval
according to	volgens
accountant	de accountant
accounting	de boekhouding
active	actief (actieve)
activity, hustle	de drukte
activity	de activiteit
address	het adres
administration	de administratie
advice	het advies
afraid, scared	bang (e)
Africa	Afrika
afternoon	de namiddag
again	"opnieuw, weer"
against	tegen
age	de leeftijd
ago	geleden
agriculture	de landbouw
air, sky	de lucht
airplane	het vliegtuig
airport	de luchthaven
alarm clock	de wekker
alcohol	de alcohol
all right	in orde
all sort of things	van alles
all	allemaal
almond biscuit	de speculaas
almost	bijna
alone	alleen
along	langs
alphabet	het alfabet
already	al
already	alweer
also	ook
always	altijd
amateur	de amateur
ambulance	de ziekenwagen
America	Amerika
amusement park	het pretpark
angry	"boos, boze"
angry	"kwaad, kwade"
animal	het dier
answer	het antwoord
antibiotic	het antibioticum
antique, ancient, old	antiek(e)
anymore, no more, (any) longer	niet meer
anyway, anyhow	in elk geval
aperitif, appetizer	het aperitief
appartment	het appartement
apple	de appel
appointment	de afspraak
arm	de arm
around, about	zowat
arrival lounge, air terminal	de aankomsthal
arrogant	arrogant(e)
art	de kunst
article	het artikel
artist	de kunstenaar
as long as	zolang
as much	even veel
as quickly as possible	zo snel mogelijk
ashtray	de asbak
Asia	Azië
assistant	de assistent
at a certain moment	op een bepaald moment
at home	thuis
at least	tenminste
at night	's nachts
at the back	achteraan
at the end	op het eind
at the top	bovenaan
at your service	tot uw dienst
at	bij
attention	de aandacht
attention	de attentie
attraction	de attractie
aunt	de tante
Australia	Australië
automatic	automatisch(e)
autonomous	autonoom (autonome)
autonomy	de autonomie
autumn, fall	de herfst
average	gemiddeld(e)
awake	wakker
away from	weg van
baby	de baby
back of the neck	de nek
back seat	de achterbank
back, hind(most)	achterste
back	de rug
back	terug
bad	slecht(e)
badly injured person	de zwaargewonde
bag	"de tas, de zak"
baker	de bakker
balcony	het balkon
ball	de bal
banana	de banaan
bank	de bank
basket	de mand
bath	het bad
bathroom	de badkamer
be!	wees! (<zijn)
beans	de boontjes
beautiful	mooi(e)
because	want
bed	het bed
bedroom	de slaapkamer
beer	het bier
before (now), sooner	eerder
before	voor
beginning	het begin
behind	achter
beige	beige
Belgian	Belgisch(e)
Belgian	de Belg
bell	de bel
belt	de riem
bench	de bank
besides, moreover	daarbij
between	tussen
beyond, past	voorbij
bicycle thief	de fietsendief
bike	de fiets
bilingual	tweetalig(e)
bill, account	de rekening
birth	de geboorte
birthday	de verjaardag
biscuit	het koekje
bit (een beetje: a bit, some)	het beetje
black	zwart(e)
blame	de schuld
blast	verdorie
blond	blond(e)
blood	het bloed
blouse	de bloes
blue	blauw(e)
body	het lichaam
bold, shameless, impudent	brutaal (brutale)
bomb	de bom
bonnet, woollen hood	de muts
book	het boek
bookcase, bookshelves	de boekenkast
boot	de laars
border	de grens
boring, annoying	vervelend(e)
born	geboren
boss, employer	de baas
both	allebei
both	beide
bottle	de fles
bottom(most)	onderste
bouquet, bunch of flowers	het boeket
boutique	de klerenwinkel
box	de doos
boy	de jongen
bra, brassière	de beha
bread	het brood
breakfast	het ontbijt
bridge	de brug
brilliant, magnificent	schitterend(e)
broadcasting cooperation	de omroep
broadcasting station, channel	de zender
brochure	de brochure
broken, torn	kapot (kapotte)
brother	de broer
brown	bruin(e)
building	de bouw
building	het gebouw
built-on	bebouwd(e)
bus	de bus
business card	het adreskaartje
business	de zaak
busy, doing something	bezig(e)
busy	druk (drukke)
but	maar
butcher	de slager
butter	de boter
button	de knoop
by day, during the day	overdag
by seven o'clock	tegen zeven uur
by	via
cabbage	de kool
café, pub	het café
cake, tartlet, pastry	het gebakje
calendar	de kalender
call	het telefoontje
can, may	kunnen
canal	het kanaal
candle	de kaars
canteen	de kantine
cap	de pet
capital	de hoofdstad
car	de auto
cardigan	het vest
career	de carrière
careful	voorzichtig(e)
caring	verzorgend(e)
carpet	het tapijt
carrot	de wortel
cash deck	de kassa
cat	de kat
catastrophe	de catastrofe
Catholicism	het katholicisme
celery	de selderij
cellar	de kelder
cen, penny, sou, a bit of money	de cent
centimetre	de centimeter
centre	het centrum
century	de eeuw
ceremonial	ceremonieel (ceremoniële)
certain	bepaald(e)
certain	sommige
certainly	vast en zeker
certificate	het attest
chair	de stoel
chance, possibility	de kans
chaos	de chaos
character	het karakter
charming	charmant (e)
cheap	goedkoop (goedkope)
cheerful	vrolijk (e)
cheers	proost!
cheese	de kaas
chemist	de apotheker
chemist's	de apotheek
chest, breast	de borst
chicken	de kip
child / family allowance	de kinderbijslag
child	het kind
children's feast, children's party	het kinderfeest
Chin up! Keep courage	kop op!
Chinese	de Chinees
chip stand	de frituur
chip stand	het frietkraam
chips, french fries	de friet
chocolate	de chocolade
chocolate	de praline
choice	de keuze
chop	de kotelet
christian	christelijk(e)
Christmas Eve	de kerstavond
Christmas period	de kerstperiode
Christmas	kerst
Christmas	kerstmis
church attendance	het kerkbezoek
church	de kerk
cigar	de sigaar
cigarette	de sigaret
cinema	de bioscoop
city centre, inner city	de binnenstad
city hall	het stadhuis
city	de stad
classical	klassiek (e)
classical	klassiek(e)
clean	schoon (schone)
clear, bright	helder(e)
clear	duidelijk
climate	het klimaat
clock	de klok
close by	vlakbij
closed, shut	dicht (e)
closed	gesloten
clothes	de kleren
cloud	de wolk
cloudy	bewolkt(e)
club	de club
coast, seaside	de kust
coat	de jas
coffee spoon	het koffielepeltje
coffee	de koffie
coin	de munt
coke	de cola
cold	de kou
cold	koud(e)
colleague	de collega
college days	de studententijd
colour	de kleur
colourful	kleurig(e)
come on, hurry	komaan
come on	vooruit
comfort, conveniences	het comfort
comfortable	comfortabel(e)
comic strip	de strip
coming	komend(e)
commemoration	de herdenking
commercial	commercieel (commerciële)
company, firm	het bedrijf
competition	de concurrentie
complete	compleet (complete)
complete	heel (hele)
complete	volledig(e)
complex	complex(e)
compulsory	verplicht(e)
computer firm	de computerfirma
computer game	het computerspel
concentration	de concentratie
concert evening	de concertavond
concert	het concert
conscious	bewust(e)
consultation	het spreekuur
contact	het contact
contemporary	hedendaags (e)
contest	de wedstrijd
continent	het werelddeel
contract	het contract
cook	de kok
cooker	het vuur
cookery book	het kookboek
cool	koel(e)
corner	de hoek
correct, all right, agreed	akkoord
corridor, hall way	de gang
cosmopolitan	kosmopolitisch(e)
costs	de kosten
cotton	het katoen
cotton	katoenen
couch, sofa, settee	de sofa
cough	de hoest
could	kon (kunnen)
country	het land
couple	het koppel
courage	de moed
course	de cursus
course	de les
cream	de crème
cream	de room
creation, origin	het ontstaan
credit card	de creditcard
credit card	de kredietkaart
crisis, economic depression	de crisis
criticism	de kritiek
croissant	de croissant
crossroads, crossing junction7	het kruispunt
crown	de kroon
cultural	cultureel (culturele)
culture	de cultuur
cup	het kopje
cupboard, wardrobe	de kast
curious	nieuwsgierig(e)
curtain	het gordijn
customer	de klant
customs	de douane
cut finely	fijngesneden
daily work, daily duties, routine	de dagtaak
daily	dagelijks(e)
damn	verdomme
danger	het gevaar
dangerous	gevaarlijk(e)
dark brown	donkerbruin(e)
dark	donker(e)
darling, love	de schat
daughter	de dochter
day off, holiday	de vakantiedag
day	de dag
dead person, deceased	de dode
dead	dood (dode)
death	de dood
decade	het decennium
decilitre	de deciliter
declaration	de aangifte
decrease, decline	de daling
degree	de graad
delay	de vertraging
democrate	de democraat
dentist	de tandarts
departement	het departement
department	de afdeling
department	de dienst
deposition	het proces-verbaal
depressed	depressief (depressieve)
depth	de diepte
desk	het bureau
dessert	het dessert
destination	de bestemming
detail	het detail
diary	de agenda
difference	het verschil
difficult	moeilijk(e)
difficulty	de moeilijkheid
dinner party	het etentje
diploma, certificate	het diploma
diplomate	de diplomaat
direction	de richting
director	de directeur
dirty	vuil(e)
disaster	de ramp
disco	de discotheek
disease, illness	de ziekte
dish	het gerecht
dismissel, resignation	het ontslag
district	het gewest
diverse, various	divers(e)
divine	goddelijk(e)
divorced	gescheiden
doctor, physician	de arts
doctor, physician	de dokter
documentary (film)	de documentaire
dog	de hond
dollar	de dollar
dominant	dominant (e)
door	de deur
double	dubbel(e)
drawer	de lade
drawing attention	hé
drawing	de tekening
dream	de droom
dress	de jurk
drink	de drank
drinking-water	het drinkwater
driver, chauffeur	de chauffeur
drop	de druppel
drug	de drug
dry	droog (droge)
Dutch-speaking	Nederlandstalig(e)
Dutch	het Nederlands
each other	elkaar
each other	"mekaar, elkaar"
each, any	elk(e)
each, every	ieder
ear	het oor
earache	de oorpijn
earlier	vroeger
early	vroeg(e)
east	het oosten
Easter egg	het paasei
Easter	het paasfeest
Easter	Pasen
easy	gemakkelijk(e)
ecological	ecologisch(e)
economic	economisch(e)
economy	de economie
education	het onderwijs
egg	het ei
eggplant	de aubergine
elegant	elegant(e)
element	het element
elevator, lift	de lift
emotional	emotioneel (emotionele)
employee	de bediende
employee	de werknemer
employer	de werkgever
empty	leeg (lege)
enclosed	ingesloten
end	het einde
engineer	de ingenieur
enormous	enorm(e)
enough	genoeg
entertainment centre	het uitgaanscentrum
enthusiastic	enthousiast (e)
entrance hall	de hal
entrance	de ingang
envelope	de envelop
error	de vergissing
especially, particularly	vooral
euro	de euro
European	Europees (Europese)
even though	ook al
even	zelfs
evening	de avond
ever	ooit
everyone, everybody	iedereen
everything	alles
everywhere	overal
ex-colleague, former colleague	de ex-collega
exact	precies
exam	het examen
example	het voorbeeld
excellent	uitstekend(e)
except	behalve
excuse me	excuseer
excuse, apology	het excuus
expensive	duur, dure
explanation	de verklaring
extensive	uitgebreid(e)
eye	het oog
face	het gezicht
fair	de kermis
fairly, rather	tamelijk
family	de familie
famous	beroemd(e)
fantasy	de fantasie
far	ver (verre)
farmer	de boer
fashion	de mode
fashionable	modieus (modieuze)
father	de vader
Father's Day	de vaderdag
favourite pub	het stamcafé
feast of St. Nicholas	het sinterklaasfeest
feastday, holiday	de feestdag
federal	federaal (federale)
feeling	het gevoel
female assistant	de assistente
female nurse	de verpleegster
female philosopher	de filosofe
female shop assistant	de verkoopster
female student	de studente
festival	het festival
festive meal	het feestmenu
festive table	de feesttafel
fever	de koorts
figure, numer	het cijfer
figure	de figuur
file	de map
finally	eindelijk
finally	ten slotte
financial	financieel (financiële)
finger	de vinger
fire	het vuur
firm	de firma
first name	de voornaam
first	eerst
fish	de vis
flat	vlak (vlakke)
Fleming	de Vlaming
flexible	soepel(e)
floor	de verdieping
floor	de vloer
flower	de bloem
flu, influenza	de griep
food, meal	het eten
foot	de voet
football club	de voetbalclub
for a long time	al lang
for free, for nothing	gratis
for instance	bijvoorbeeld
for rent	te huur
for sale	te koop
foreign countries	het buitenland
foreign	buitenlands(e)
foreign	vreemd(e)
foreigner	de buitenlander
foreigner	de vreemdeling
fork	de vork
form	het formulier
forty days'	veertigdaags(e)
frankly	eerlijk gezegd
freezer, deepfreeze	de diepvries
French speaking	Franstalig(e)
French	Frans(e)
fresh, cold	fris (frisse)
fresh	vers(e)
fridge	de koelkast
fried	gebakken
friend, boy friend	de vriend
friendly	vriendelijk(e)
from, starting from	vanaf
from, starting from	vanuit
from	uit
front	voorste
frozen chicken	de diepvrieskip
fruit juice	het fruitsap
fruit	het fruit
full	vol (volle)
fully booked, sold out, booked out	uitverkocht(e)
function	de functie
funny	grappig(e)
further	verder
garage	de garage
garden	de tuin
gate	de poort
general	algemeen (algemene)
German	Duits(e)
gift, present	het cadeau
gift	het geschenk
girl	het meisje
gladly, with pleasure	graag
glas	het glas
glass of beer	het biertje
glasses, spectacles	de bril
glorious, heavenly	zalig(e)
god	de god
good afternoon	goedemiddag
good day / hello	goedendag
good evening	goedenavond
good morning	goedemorgen
good night	goedenacht
good night	slaapwel
good night	welterusten
good, tasty	lekker(e)
good	braaf (brave)
good	goed(e)
goodbye	tot ziens
government	de regering
gram	de gram
grammar	de grammatica
grandchild	het kleinkind
grandmother	de grootmoeder
grandson	de kleinzoon
grass	het gras
great, excellent	prima
great, smashing	tof (toffe)
great	geweldig(e)
green	groen(e)
greeting card	de wenskaart
greeting	de groet
grey	grijs (grijze)
ground, floor	de grond
group	de groep
growth	de groei
guide	de gids
guy, chap	de kerel
habit	de gewoonte
hair	het haar
hairdresser	de kapper
hairdresser's	het kapsalon
hairstyle, haircut	het kapsel
half	de helft
half	half (halve)
hall-stand, hatrack	de kapstok
ham	de ham
hand bag	de handtas
hand	de hand
handball club	de handbalclub
handkerchief	de zakdoek
handsome, good-looking	knap (knappe)
happiness	het geluk
happy, glad, pleased	blij(e)
happy, glad, pleased	gelukkig(e)
hard	hard(e)
hat	de hoed
have to, must	moeten
having a cold	verkouden
head	het hoofd
headache	de hoofdpijn
health insurance	de ziekteverzekering
health	de gezondheid
healthe service	het ziekenfonds
healthy	gezond(e)
heart	het hart
heating, radiator	de verwarming
heavy	zwaar (zware)
hectare	de hectare
height	de hoogte
helicopter	de helikopter
hello	hallo
help	de hulp
help	help!
here	hier
hereby, herewith	hierbij
high	hoog (hoge)
highest	hoogste
historian	de historicus
historic	historisch(e)
history of art	de kunstgeschiedenis
history	de geschiedenis
hobby	de hobby
hole	het gat (gaten)
holiday	de vakantie
honest	eerlijk(e)
hope	de hoop
hopefully, let's hope	hopelijk
horse	het paard
hospitable	gastvrij(e)
hospital	het ziekenhuis
hotel	het hotel
hour	het uur
hour	het uurtje
house, dwelling	de woning
house	het huis
housewife	de huisvrouw
human being, person	de mens
hunger	de honger
I say,	zeg
I wish you a good recovery, get well soon	Veel beterschap!
I wouldn't know. How would I know?	ik zou het niet weten
icecream	het ijsje
idea	het idee
identity card	de identiteitskaart
identity	de identiteit
if	als
ill	ziek(e)
image	het beeld
image	het imago
immediately, straight away	dadelijk
immediately	meteen
immediately	onmiddellijk
important	belangrijk(e)
impression	de indruk
in love	verliefd (e) (op)
in search of	op zoek naar
in short, brief	kortom
in the afternoon	's middags
in the beginning	in het begin
in the first place, in the second place	ten eerste, ten tweede
in the front	vooraan
in the morning	's morgens
in the open (air)	in de openlucht
in	in
in/during the evening	's avonds
including	inclusief (inclusieve)
income	het inkomen
indeed	inderdaad
independent	zelfstandig(e)
Indian	Indisch(e)
industrial	industrieel (industriële)
industry	de industrie
influence	de invloed
information brochure on holiday trips	de vakantiebrochure
information	de informatie
inhabitant of Brussels	de Brusselaar
inhabitant	de inwoner
initiative	het initiatief
injection	het spuitje
injured person, casualty	de gewonde
inside	binnen
instead of	in plaats van
insurance	de verzekering
intelligent	intelligent(e)
intensive	intensief (intensieve)
interest	de interesse
interested	geïnteresseerd (e)
interested	geïnteresseerd(e)
interesting	interessant(e)
international	internationaal (internationale)
internet	het internet
Islam	de islam
It's all the same to me.	om het even
Italian	het Italiaans
Italian	Italiaans(e)
jacket	het jasje
jam	de confituur
jealous	jaloers (e)
job	de baan
joke	de grap
journalist	de journalist
journey	de reis
Judaism	het jodendom
jumper	de trui
jurisdiction	de rechtspraak
just (now)	zopas
just for a moment	even
just like that, without difficulty	zomaar
just now, then	daarnet
just, at this moment	net
just, simply	gewoon
Keep courage	moed houden!
key	de sleutel
kilo	de kilo
kilometre	de kilometer
kindergarten	de kleuterschool
king	de koning
kiss	de kus
kitchen cupboard	de keukenkast
kitchen	de keuken
knee	de knie
knife	het mes
labour costs	de loonkosten
lady	de dame
lake	het meer
lamp, light	de lamp
landlord	de huisbaas
language border	de taalgrens
language region	het taalgebied
language	de taal
large (size)	large
large, tall	groot (grote)
last	laatste
last	vorig(e)
late	laat (late)
later	later
law	de wet
lawyer	de advocaat
leaf	het blad
leather	het leer
leather	leren
leeks	de prei
left	links
leg	het been
legal	legaal (legale)
lemon	de citroen
less, fewer	minder(e)
letter	de brief
letter	de letter
lettuce	de sla
library	de bibliotheek
life	het leven
light beige	lichtbeige
light, not dark, not heavy	licht(e)
light	het licht
light	licht(e)
like	zoals
line	de lijn
line	de streep
linguistic	linguïstisch(e)
lip	de lip
list	de lijst
litre	de liter
little boy	het jongetje
little, not much, not a lot	weinig(e)
little, small	klein(e)
lively, animated	levendig(e)
living room	de woonkamer
living wage	het leefloon
living-room	de living
local	plaatselijk(e)
lock	het slot
locked	op slot
logic	de logica
long	lang(e)
longing, desire	het verlangen
lost	kwijt
love	de liefde
lover	de liefhebber
low	laag (lage)
luggage	de bagage
lump	het klontje
lunchbreak	de lunchpauze
made	gemaakt (maken)
magazine	het tijdschrift
mail, post	de post
majority	de meerderheid
male nurse	de verpleger
man, gentleman	de heer
man	de man
mandarin orange	de mandarijn
many	veel (vele)
map	de kaart
market	de markt
marketing manager	de marketing manager
married	getrouwd(e)
marzipan	de marsepein
match box	het lucifersdoosje
match	de lucifer
match	de match
material, cloth	de stof
maybe	misschien
mayonnaise	de mayonaise
meadow, pasture	de weide
meal	de maaltijd
meat used in a stew	het stoofvlees
meat	het vlees
medicine	het drankje
medicine	het medicijn
medieval	middeleeuws (e)
Mediterranean Sea	de Middellandse Zee
medium (size)	medium
medium-sized	middelgroot (middelgrote)
meeting place	de ontmoetingsplaats
member	het lid
memory	de herinnering
message, errand, purchase	de boodschap
meter	de meter
middle, centre	het midden
migrant	de migrant
milk	de melk
million	miljoen
minimum	het minimum
minister	de minister
minute	de minuut
mirror	de spiegel
misery, misfortune	de miserie
miss	de juffrouw
misses, Mrs	de mevrouw
mister, Mr	de meneer
moderate	gematigd(e)
modern	modern(e)
moment	het moment
moment	het ogenblik
Monday morning	de maandagochtend
money	het geld
monolingual	eentalig(e)
month	de maand
moreover	bovendien
morning	de morgen, de ochtend
morning	de ochtend
morning	voormiddag
Moroccan	Marokkaans(e)
most	meeste
mostly, usually	meestal
mother tongue	de moedertaal
mother	de moeder
Mother's Day	de moederdag
mountain	de berg
mouth	de mond
movie	de film
much too	veel te
multilingual	meertalig(e)
municipal	gemeentelijk(e)
municipality	de gemeente
muscle	de spier
muscular pain	de spierpijn
museum	het museum
music festival	het muziekfestival
music lover	de muziekliefhebber
music	de muziek
mussel	de mossel
name	de naam
namely	namelijk
narrow	smal (smalle)
national	nationaal (nationale)
nationality	de nationaliteit
nature	de natuur
naughty	stout(e)
necessary	nodig (e)
necessary	noodzakelijk(e)
neck	de hals
negative	negatief (negatieve)
neighbour	de buur
neighbouring country	het buurland
net	netto
never	nooit
nevertheless, all the same, still	toch
New Year's Eve	het oud(e)jaar
New Year's period	de nieuwjaarsperiode
new	nieuw(e)
news	het nieuws
newspaper basket	de krantenmand
newspaper price	de krantenprijs
newspaper	de krant
newspaper	het dagblad
next, after that	daarna
next	naast
next	volgend(e)
nice, kind, sweet	lief (lieve)
nice, kind	aardig (e)
nice, pleasant	leuk(e)
nice	prettig(e)
night	de nacht
no one, nobody	niemand
nobody else	niemand anders
noise	het lawaai
none at all	helemaal geen
nonsense	de onzin
noon	de middag
normal	gewoon (gewone)
normal	normaal (normale)
north east	het noordoosten
north west	het noordwesten
north	het noorden
nose drops	de neusdruppels
nose	de neus
not anymore	geen ... meer
not at all	helemaal niet
not before	pas
not even	niet eens
not for a long time	nog lang niet
not	niet
note	het briefje
nothing	niets
nowhere	nergens
nucleus family (father, mother and children)	het gezin
nucleus family: father, mother and children	het gezin
number	het aantal
number	het nummer
nurse	de verpleegkundige
nylon	nylon
occupation, professin	het beroep
odd, peculiar, strange	raar (rare)
of age, adult	volwassen
of course	natuurlijk
office	het kantoor
official, civil servant	de ambtenaar
official	officieel (officiële)
often	dikwijls
often	vaak
oh, ah well	ach
old	oud(e)
older, elder	ouder(e)
oldest, eldest	oudste
omelette	de omelet
on the one hand	aan de ene kant
on the other hand	aan de andere kant
on, at	op
on	aan
once in a while	wel eens
once in a while	weleens
once	(nog) eens
one and a half	anderhalf (anderhalve)
one, people, they	men
oneself	"zelf, zichzelf"
onion	de ui
only	alleen
only	alleen maar
only	nog maar
only	slechts
oops	oei
oops	oeps
open	open
operation	de operatie
opposite	tegenover
or so, or that sort of things	of zo
or	of
orange juice	het sinaasappelsap
orange	de sinaasappel
orange	oranje
orchestra	het orkest
order	de orde
organization, institution	de instelling
organization	de organisatie
other	ander(e)
otherwise	anders
ouch, ai, ah, when expressing pain or sorrow	ai!
outside	buiten
over	over
overcoat	de overjas
own	eigen
package, carton	het pak
pain in the back	de rugpijn
pain	de pijn
painter	de schilder
painting	het schilderij
pair of jeans	de jeans
pair	het paar
pale	bleek (bleke)
pan, kettle	de kookpan
pan, kettle	de pan
pancake	de pannenkoek
paper basket	de papiermand
paper	het papier
paper	papieren
parade, procession	de stoet
pardon	pardon
parents	de ouders
parish priest	de pastoor
park	het park
parking garage	de parkeergarage
parliament	het parlement
parsley	de peterselie
part	het deel
particular, special, extraordinary	bijzonder(e)
partly	voor een deel
party	het feestje
passenger	de passagier
passport control	de paspoortcontrole
passport	het paspoort
past	het verleden
past	voorbij(e)
pastry shop	de patisserie
path	het pad
patience	het geduld
patient	de patiënt
pay card	de betaalkaart
pay, wages, salary	het loon
pea	de erwt
pen	de pen
pension, retirement pay	het pensioen
pepper	de peper
per	per
perfect	perfect(e)
perfume	het parfum
period	de periode
person	de persoon
personal	persoonlijk(e)
pessimistic	pessimistisch(e)
pet	het huisdier
philosopher	de filosoof
piano	de piano
picture, photo	de foto
piece	het stuk
pigeon	de duif
pill, tablet	de pil
pink	roze
pit	de parterre
place of residence	de woonplaats
place	de plaats
plan	het plan
plastic	plastic
plate	het bord
platform	het perron
pleasant, agreable	aangenaam (aangename)
pleasant, agreeable	aangenaam (aangename)
pleasant, enjoyable, cosy	gezellig(e)
pleasant	plezierig(e)
please, here you are	alsjeblieft
please, here you are	alstublieft
pleased, satisfied	tevreden
pleasure	het genoegen
pleasure	het plezier
pocket money	het zakgeld
police officer	de politieagent
police station	het politiebureau
police	de politie (enk.)
political	politiek(e)
politician	de politicus
politics	de politiek
pollution	de vervuiling
pop concert	het popconcert
popular, of the common people	volks(e)
popular	populair(e)
population	de bevolking
port (wine)	de porto
port, harbour	de haven
possible	mogelijk(e)
post office	het postkantoor
postcard	de postkaart
pot	de pot
potato	de aardappel
practical	praktisch(e)
prescription	het voorschrift
present	aanwezig(e)
price tag, price ticket	het prijskaartje
price	de prijs
primary school	de basisschool
prince	de prins
priority	de voorrang
probably	waarschijnlijk
problem	het probleem
product	het product
productivity	de productiviteit
professor	de professor
profit, return	de winst
programme	het programma
promotion	de promotie
Protestantism	het protestantisme
proud	trots(e)
province	de provincie
psychiater	de psychiater
pudding, custard	de pudding
pupil	de leerling
purple	paars(e)
purse	de portemonnee
quality	de kwaliteit
quarrel, row, fight	de ruzie
quarter of an hour	het kwartier
quarter	het kwart
question	de vraag
quick, fast	snel (snelle)
quick, fast	Snel!
quick, fast	vlug (vlugge)
quick, fast	Vlug!
quickly	gauw
quiet	rustig(e)
quite, rather	nogal
quite	best
quiz	de quiz
railway ticket	het treinkaartje
rain	de regen
raincoat	de regenjas
rather	liever
reader of newspapers	de krantenlezer
reader	de lezer
ready	klaar (klare)
real	echt(e)
reality	de realiteit
really, actually, in fact	eigenlijk
really	echt waar
reason	de reden
reason	het verstand
recent	recent(e)
recipe	het recept
record	de plaat
recovery	de genezing
red	rood (rode)
reduction	de reductie
reflex	de reflex
region	de regio
region	de streek
regional	regionaal (regionale)
regularly	regelmatig(e)
relation, relationship	de relatie
relative	relatief (relatieve)
religion	de godsdienst
religion	de religie
religious, ecclesiastical	kerkelijk(e)
renovated	vernieuwd(e)
rent	de huur
report	het rapport
rest, quiet	de rust
rest	de rest
restructuring, reorganization	de herstructurering
result	het resultaat
retirement pay	het pensioengeld
return ticket	het retour
rice	de rijst
rich	rijk(e)
right side	de rechterkant
right	het recht
right	juist(e)
right	rechts
rise, increase	de stijging
river	de rivier
road	de weg
roll	het broodje
romantic	romantisch(e)
roof	het dak
room	de kamer
room	de zaal
rose	de roos
round, around	rond
round	rond(e)
row	de rij
sad	triest(e)
Saint Nicholas, the feast of St. Nicholas	de Sinterklaas
salt	het zout
scarf	de sjaal
school mistress	de onderwijzeres
school	de school
schoolbook	het schoolboek
schooling	de opleiding
schoolteacher	de onderwijzer
sea	de zee
secondary school, high school	de middelbare school
sector	de sector
security	de zekerheid
seldom	zelden
self-employed person	de zelfstandige
separated	uit elkaar
september	september
service	de bediening
service	de dienst
several	verschillende
shall, will	zullen
shampoo	de shampoo
shelf	het rek
sherry	de sherry
shirt	het overhemd
shoe	de schoen
shop	de winkel
shopping list	het boodschappenlijstje
shopping street	de winkelstraat
short	kort(e)
shorts	de short
shower	de douche
Shrovetide, carnaval	het carnaval
side	de kant
sign, notice	het bordje
silk	de zijde
silk	zijden
simple	eenvoudig(e)
simple	simpel (e)
since	sinds
singlet	het onderhemd
sister	de zus
situation	de situatie
situation	de toestand
size	de maat
skiing holiday	de skivakantie
skirt	de rok
sleeve	de mouw
slice of bread	de boterham
slim	mager(e)
slow	langzaam
small bottle	het flesje
small present	het cadeautje
small shop	het winkeltje
small table	het tafeltje
smaller	kleiner(e)
snow	de sneeuw
so far, up to now, until now	tot nog toe
so much / many	zoveel
so	dus
so	zo
soap	de zeep
soccer, football	het voetbal
social	sociaal (sociale)
society, association	de vereniging
sock	de sok
soft	zacht(e)
solution	de oplossing
some, a few	enkele
somebody else	iemand anders
someone	iemand
something giving trouble	last hebben van
something	iets
sometimes	soms
somewhere, anywhere	ergens
son	de zoon
sonata	de sonate
song	het lied
soon, shortly	binnenkort
soon	straks
sore throat	de keelpijn
sorrow, pain, grief	het verdriet
sorry	sorry
sort, kind, variety	de soort
soup	de soep
south east	het zuidoosten
south west	het zuidwesten
south	het zuiden
space	de ruimte
spacious	ruim(e)
spaghetti	de spaghetti
special	speciaal (speciale)
splendid, grand, magnificent	prachtig(e)
spontaneous	spontaan (spontane)
spoon	de lepel
sport	de sport
sports centre	de sportzaal
sports club	de sportclub
sports-loving	sportief (sportieve)
spring concert	het lenteconcert
spring	de lente
square	het plein
stable	de stal
stable	stabiel(e)
staff, employees	het personeel
stairs	de trap
stamp	de postzegel
state	de staat
station	het station
statistic(s)	de statistiek
stay	het verblijf
steak, rump steak	de biefstuk
step	de stap
stewardess	de stewardess
still (another, some, any, more ...), Nog iets: Anything else, Nog vragen: Any more questions?	nog
stocking	de kous
stomach	de maag
story	het verhaal
straight on	rechtdoor
straight	recht(e)
strange	vreemd(e)
street	de straat
strike	de staking
striking, eye catching	opvallend(e)
strong	sterk(e)
student	de student
student's card	de studentenkaart
students' restaurant	het studentenrestaurant
study, research	het onderzoek
stupid	dom (domme)
style	de stijl
subject	het vak
subscriber, season ticket holder	de abonnee
success	het succes
such a	zo'n
such	zo'n
such	zulk(e)
sudden(ly)	plotseling
suddenly	opeens
sugar	de suiker
suit	het kostuum
suitcase	de koffer
summer	de zomer
sun	de zon
Sunday	zondags(e)
sunny	zonnig(e)
superb, outstanding	super
supermarket	de supermarkt
support	de steun
sure, certainly	zeker
surname	de achternaam
sweet	het snoepje
sweet	zoet(e)
sweets	de snoep
symbolic	symbolisch(e)
sympathetic	sympathiek (e)
table	de tafel
tap	de kraan
taste	de smaak
tasty, appetizing	smakelijk(e)
taxi	de taxi
tea	de thee
teacher	de leerkracht
teacher	de leraar
technical	technisch(e)
technological	technologisch(e)
telephone number	het telefoonnummer
telephone	de telefoon
television channel	het televisiestation
television	de televisie
television	de televisie (tv)
temperature	de temperatuur
temporary	voorlopig(e)
tennis club	de tennisclub
terrace	het terras
terrible	verschrikkelijk(e)
terrible	vreselijk(e)
territory, region	het gebied
text	de tekst
thank you	dank u wel
thanks	bedankt
that's all right, you're welcome, not at all	geen dank
the day after tomorrow	overmorgen
the day before yesterday	eergisteren
the place of birth	de geboorteplaats
the same	dezelfde
the same	hetzelfde
the two of us	met ons tweeën
theatre	de schouwburg
theatre	het theater
theft	de diefstal
then	dan
there and back	heen en terug
there	daar
therefore, so	daarom
these days	tegenwoordig
thick, fat	dik (dikke)
thief	de dief
thin	dun/dunne
thing	het ding
think something impossible, believe something to be impossible	niet voor mogelijk houden
thirst	de dorst
this afternoon, today at noon	vanmiddag
this morning	vanmorgen
this morning	vanochtend
three times	driemaal
throat	de keel
through	door
thyme	de tijm
ticket office	het loket
ticket	het kaartje
tie, bond	de band
tie	de das
time of departure	het vertrekuur
time	de keer
time	de tijd
tin	het blik
tired	moe (moeë)
title	de titel
to achieve, reach	boeken
to adapt	aanpassen
to address	aanspreken
to amuse, to entertain	amuseren
to answer the phone	opnemen
to answer	antwoorden
to apply for	solliciteren
to arise	ontstaan
to arrive home	thuiskomen
to arrive	aankomen
to ask a question	een vraag stellen
to ask	vragen
to attract attention, to catch the eye	opvallen
to be (switched) on	aanstaan
to be about, to deal with	gaan over
to be aware / conscious of	zich bewust zijn van
to be called	heten
to be entitled to	recht hebben op
to be fired / booted	op straat staan
to be linked / connected	samenhangen
to be located	liggen
to be mistaken	(zich) vergissen
to be on visiting terms with someone	aan huis komen
to be overjoyed	in de wolken zijn
to be pleased / comfortable	het naar zijn zin hebben
to be ready	klaarliggen
to be ready	klaarstaan
to be right	gelijk hebben
to be silent	zwijgen
to be surprised / shocked	schrikken
to be talking about	het hebben over
to be very busy	het druk hebben
to be	zijn
to become	worden
to begin, to start	beginnen
to believe	geloven
to bloom, to blossom	bloeien
to blow	waaien
to book	reserveren
to bore, annoy, irritate	vervelen
to bow, to bend	buigen
to break	breken
to breathe	ademen
to bring along	meebrengen
to bring	brengen
to brush, to clean	poetsen
to build	bouwen
to bury	begraven
to buy	kopen
to call in	binnenroepen
to call, to schout	roepen
to call	noemen
to cause	zorgen voor
to celebrate, to feast	feesten
to celebrate	vieren
to change	veranderen
to chat	babbelen
to chat	chatten
to check	controleren
to choose	kiezen
to climb	klimmen
to close, to conclude	afsluiten
to close	sluiten
to collect	verzamelen
to comb	kammen
to come along, accompany	meekomen
to come back	terugkomen
to come outside / outdoors	buitenkomen
to come to an end, to finish, expire	aflopen
to come together, to meet	samenkomen
to come, go along	meerijden
to come	komen
to commemorate	herdenken
to continue	voortwerken
to contradict a negation	wel
to cook	koken
to cost	kosten
to cough	hoesten
to count	rekenen
to count	tellen
to cross	oversteken
to cry, weep	huilen
to cut with a knife	snijden
to cut	knippen
to dance	dansen
to dare	durven
to decide	beslissen
to decide	besluiten
to declare	aangeven
to develop	ontwikkelen
to die	sterven
to diminish, to decline	achteruitgaan
to disappear	verdwijnen
to disappoint	tegenvallen
to do one's best	zijn best doen
to do the dishes	afwassen
to do	doen
to draw up	opstellen
to draw	tekenen
to dream	dromen
to dress	aankleden
to drink up, to finish	opdrinken
to drink	drinken
to drive off	wegrijden
to drive, ride	rijden
to drive, to ride (a)round	rondrijden
to drop in on someone, to visit	langsgaan
to drop in on someone, to visit	langslopen
to dry	drogen
to earn	verdienen
to eat	eten
to eat	opeten
to enjoy	genieten van
to enter	binnengaan
to enter	binnenkomen
to examine	onderzoeken
to excuse, to apologize	verontschuldigen
to exercise, to practise	oefenen
to exist	bestaan
to expect	verwachten
to experience	meemaken
to explain	uitleggen
to fail	zakken
to fall asleep	in slaap vallen
to fall	vallen
to fear	vrezen
to feel like, fancy	zin hebben in
to feel	(zich) voelen
to feel	voelen
to fetch	halen
to fight	vechten
to fill in	invullen
to find	vinden
to fire	ontslaan
to fly	vliegen
to forget	vergeten
to form	vormen
to fry, bake	bakken
to get acquainted with, to get to know	kennismaken
to get angry, to lose one's temper	zich boos maken op
to get back, to find	terugvinden
to get back	terugkrijgen
to get excited about something	zich druk maken (over)
to get in	instappen
to get up, to rise on one's feet	rechtstaan
to get up	opstaan
to give a person something as a present	iemand iets cadeau doen
to give up, renounce	afstaan
to give	geven
to go along, accompany	meegaan
to go down, to drop	dalen
to go out	uitgaan
to go shopping	winkelen
to go through, pass through, keep (on) walking	doorlopen
to go, walk around	rondlopen
to go	gaan
to grow, increase	groeien
to grow, to increase	groeien
to guarantee	garanderen
to hang	hangen
to happen	gebeuren
to hate	haten
to have breakfast	ontbijten
to have dialled the wrong number	verkeerd verbonden
to have on, to be wearing	aanhebben
to have something to do with	te maken hebben met
to have	hebben
to hear	horen
to help	helpen
to hire, to rent	huren
to hope	hopen
to hurry	(zich) haasten
to hurry	opschieten
to hurt	pijn doen
to insure	verzekeren
to interest	interesseren
to interrupt	onderbreken
to introduce	voorstellen
to invite	uitnodigen
to jump	springen
to keep on walking	verder lopen
to keep open	openhouden
to know	kennen
to know	weten
to last	duren
to laugh	lachen
to lead to	leiden naar
to learn	leren
to leave a place, to go outside	buitenstappen
to leave behind	achterlaten
to leave	laten
to leave	vertrekken
to leave	weggaan
to lie, not tell the truth	liegen
to like, love	houden van
to listen (in), to overhear	meeluisteren
to listen with one ear	met een half oor meeluisteren
to listen	luisteren
to live	leven
to live	wonen
to look after, to see to	zorgen
to look at	bekijken
to look like	eruitzien
to look out, to be careful, to take care	oppassen
to look round	rondkijken
to look through	doorkijken
to lose touch / contact	uit het oog verliezen
to lose	verliezen
to make a declaration	aangifte doen
to make an appointment, arrange a time/place	afspreken
to make coffee	koffie zetten
to make use of	gebruik maken van
to make	maken
to marry	trouwen
to matter	niets uitmaken
to matter	schelen
to mean	bedoelen
to mean	betekenen
to mean	menen
to meet	ontmoeten
to miss	missen
to move	bewegen
to move	verhuizen
to need, have to	hoeven
to need	nodig hebben
to offer, to give	aanbieden
to offer	bieden
to open	opendoen
to open	openmaken
to operate on	opereren
to order	bestellen
to organize	organiseren
to paint	schilderen
to park	parkeren
to pass, go by	voorbijgaan
to pass	slagen
to pay	betalen
to phone	opbellen
to phone	telefoneren
to play cards	"kaarten, kaartspelen"
to play chess	schaken
to play football, soccer	voetballen
to play tennis	tennissen
to play the piano	pianospelen
to play	spelen
to pour	gieten
to pray	bidden
to prepare	klaarmaken
to prescribe	voorschrijven
to produce	produceren
to promise	beloven
to publish	publiceren
to pull in	binnenrijden
to push	duwen
to put on	aantrekken
to put, to lay	leggen
to put	steken
to rain	regenen
to react	reageren
to read	lezen
to receive	krijgen
to receive	ontvangen
to recognize	herkennen
to recover, to cure	genezen
to refuse	weigeren
to release, to let go	loslaten
to remember	herinneren
to remember	onthouden
to resemble	lijken op
to resign	ontslag nemen
to rest, to repose	uitrusten
to rest	rusten
to retire, to be retired	met pensioen gaan / zijn
to ride a bike, to cycle	fietsen
to ring the doorbell	aanbellen
to ring, to phone	bellen
to rise, increase	stijgen
to run away	weglopen
to run errands	boodschappen doen
to say	zeggen
to search, to look for	zoeken
to see again	terugzien
to see	zien
to seem, look like	lijken
to sell	verkopen
to send	opsturen
to serve	opdienen
to set out	klaarzetten
to settle, arrange	regelen
to share	delen
to shave	scheren
to shine	schijnen
to show, to point	wijzen
to show	tonen
to sign	(onder)tekenen
to sing	zingen
to sit	zitten
to ski	skiën
to sleep	slapen
to smell	ruiken
to smoke	roken
to snow	sneeuwen
to solve	oplossen
to sound familiar	bekend in de oren klinken
to sound	klinken
to speak	spreken
to spell	spellen
to stand	staan
to stay home	thuisblijven
to stay, visit, stay over for the night	logeren
to stay	blijven
to steal	stelen
to step, to walk	stappen
to stop	ophouden (met)
to stop	stoppen
to study	studeren
to succeed, to be successful	lukken
to surf	surfen
to swim	zwemmen
to take along	meenemen
to take care of, to look after	opvangen
to take care of	verzorgen
to take off, to turn off	uitdoen
to take photographs	fotograferen
to take up, to adopt	overnemen
to take, grab	pakken
to take, to swallow (a medicine)	innemen
to take	aannemen
to take	nemen
to talk	praten
to taste good, nice	smaken
to taste	proeven
to teach	lesgeven
to tear	scheuren
to telephone	telefoneren
to tell	vertellen
to thank	bedanken
to think favourably of	het zien zitten
to think, reflect on	nadenken
to think	denken
to throw	gooien
to to go (a)round	rondgaan
to travel	reizen
to trust	vertrouwen
to try on	passen
to try	proberen
to turn out all right	in orde komen
to turn out better than expected	meevallen
to turn, drive into	inrijden
to understand	begrijpen
to understand	verstaan
to undress	uitkleden
to use	gebruiken
to visit	bezoeken
to visit	langskomen
to wait	wachten
to walk into	inlopen
to walk, go, run	lopen
to walk	wandelen
to want	willen
to warn	waarschuwen
to wash	wassen
to watch, to look at	kijken (naar), bekijken
to wear, to have on one's head	ophebben
to wear	dragen
to weigh	wegen
to wipe dry	afdrogen
to wish	wensen
to wonder	afvragen (zich)
to work	werken
to worry about	(zich) ongerust maken (over)
to write	schrijven
today	vandaag
toe	de teen
together	samen
toilet paper	het toiletpapier
toilet	het toilet
tolerant	tolerant(e)
tomato	de tomaat
tomorrow morning	morgenochtend
tonight	vanavond
tonight	vannacht
too	te
tooth	de tand
toothache	de tandpijn
top(most), upper	bovenste
total, entire	totaal (totale)
totally	helemaal
tourist	de toerist
touristy	toeristisch (e)
towel	de handdoek
tower	de toren
track	het spoor
trade center	het handelscentrum
trade union	de vakbond
trade	de handel
trading town, commercial centre	de handelsstad
tradition	de traditie
traditional	traditioneel (traditionele)
traffic jam	de file
traffic	het verkeer
train	de trein
training	de training
travel agency	het reisbureau
travel insurance	de reisverzekering
tree	de boom
triangle	de driehoek
trip	de trip
trolley	de winkelkar
trouble, inconvenience	de last
truck driver	de vrachtwagenchauffeur
truck	de vrachtwagen
true	waar (ware)
Turkish	Turks(e)
turn	de beurt
twice	tweemaal
typical	typisch (e)
ugly	lelijk(e)
umbrella	de paraplu
uncle	de oom
under	onder
underpants	de onderbroek
unemployed person	de werkloze
unemployed	werkloos (werkloze)
unemployment	de werkloosheid
unhappy	ongelukkig(e)
unique	enig(e)
unique	uniek(e)
university	de universiteit
unknown	onbekend(e)
up(wards)	omhoog
user	de gebruiker
usually	gewoonlijk
V.A.T. value added taks	de btw
vacancy	de vacature
vacant	vrij(e)
vase	de vaas
vegetable	de groente
very	bijzonder
very	erg
very	heel
very	zeer
view	het uitzicht
village pub	het dorpscafé
village square	het dorpsplein
village	het dorp
voice	de stem
volleyball club	de volleybalclub
waffle	de wafel
waiting room	de wachtzaal
wall	de muur
wallet	de portefeuille
Walloon	de Waal
war	de oorlog
wardrobe	de kleerkast
warm, hot	warm(e)
washbasin	de wastafel
washing	de wasbeurt
watch	het horloge
water	het water
weather report	het weerbericht
weather	het weer
week	de week
weekend	het weekend
weekly	wekelijks(e)
welcome	welkom
well (to start an explanation)	wel (wel, ...)
well-known	bekend (e)
west	het westen
wet	nat (natte)
What do you mean? In what way? How's that?	hoezo
What happened?	Wat is er gebeurd?
What is going on?	Wat is er aan de hand?
What is it called?	Hoe heet het ook al weer?
What is the matter?	Wat scheelt er?
what kind of	wat voor (een)
when	toen
which	welk(e)
while	terwijl
whisky	de whisky
white	wit (witte)
why	waarom
wide	breed (brede)
window	het raam
wine	de wijn
winter	de winter
wise	wijs (wijze)
wish	de wens
without any logic	zonder enige logica
without	zonder
woman friend, girl friend	de vriendin
woman	de vrouw
woman's bicycle	de damesfiets
wonderful, delicious	heerlijk(e)
wood, forest	het bos
wool	de wol
woollen	wollen
word	het woord
work, labour	de arbeid
work, working place	het werk
work	het werk
working day	de werkdag
working population	de actieven
world war	de wereldoorlog
world	de wereld
worried	ongerust(e)
worth	waard zijn
would	zou / zouden (zullen)
writer	de schrijver
writing desk	de buurt
wrong, mistaken	verkeerd(e)
year	het jaar
yearly	jaarlijks(e)
yellow	geel (gele)
yesterday	gisteren
yoghurt	de yoghurt
you never know	je weet nooit
you're welcome	graag gedaan
young person	de jongere
young	jong(e)
youngest	jongste
yours faithfully, truly, sincerely	hoogachtend
youth association, youth club	de jeugdbeweging
youth	de jeugd
